0000000000000000
0000000000000000
0001000000000000
0001000300400000
0001000000000000
0001000000000000
0001000000000000
1111000300400000
0000000000000000
0000000000000000
0000000000000000
0000000000000000
0000000000000000
0000000000000000
0000000000000000
0000000000000002
