0000000100000000
4000030100000000
1111110100000000
0000010100000000
0000010100000000
0000010100000000
0000010100000000
0000010100000000
0000012100000000
0000000000000000
0000000000000000
0000000000000000
0000000000000000
0000000000000000
0000000000000000
0000000000000000
