0000000001000002
0000000001100000
1111100000110000
0000100000011100
0000100000000100
0000100000000100
0000100000000100
0000100400300100
0001100000000100
0001000000000100
0001000000000100
0001000000000100
0001111110000100
0000000010000000
0030000000000000
0000000000000000
