0000000110000000
0000003410000000
0000000110000000
0000000000000000
0000000110000000
0000003410000000
0000000110000000
0000000000000000
0000000200000000
0000000000000000
0000000000000000
0000000000000000
0000000000000000
0000000000000000
0000000000000000
0000000000000000
